     1   2   3   4   5   6   7   8   9   10   
- A |   | X |   |   | X |   |   | X |   | X |
---------------------------------------------
- B |   |   |   |   |   |   |   | X |   |   |
---------------------------------------------
- C |   |   |   |   |   |   |   |   |   |   |
---------------------------------------------
- D |   |   |   |   | X |   | X |   |   |   |
---------------------------------------------
- E |   | X |   |   |   |   |   |   |   |   |
---------------------------------------------
- F | X |   |   |   |   |   |   |   | X |   |
---------------------------------------------
- G |   |   |   |   |   |   |   | X |   |   |
---------------------------------------------
- H | X |   |   |   | X |   |   |   |   |   |
---------------------------------------------
- I |   |   |   |   |   |   |   | X |   |   |
---------------------------------------------
- J |   |   |   |   | X |   |   |   |   |   |
---------------------------------------------
     1   2   3   4   5   6   7   8   9   10   
- A |   |   | X |   |   |   |   |   |   |   |
---------------------------------------------
- B |   |   |   | X | X |   | X |   |   |   |
---------------------------------------------
- C |   | X |   | X |   |   |   |   |   |   |
---------------------------------------------
- D |   |   |   |   | X |   |   | X |   |   |
---------------------------------------------
- E |   |   |   |   |   |   |   |   |   |   |
---------------------------------------------
- F |   |   |   |   |   | X |   |   |   |   |
---------------------------------------------
- G |   |   | X |   | X |   |   |   |   |   |
---------------------------------------------
- H |   |   |   |   |   |   |   |   |   |   |
---------------------------------------------
- I |   |   |   | X |   |   |   |   |   |   |
---------------------------------------------
- J |   |   |   |   | X |   | X |   |   |   |
---------------------------------------------
     1   2   3   4   5   6   7   8   9   10   
- A |   |   |   |   |   |   |   |   |   |   |
---------------------------------------------
- B |   |   |   |   |   | X | X |   |   |   |
---------------------------------------------
- C |   | X | X |   |   |   |   |   |   | X |
---------------------------------------------
- D |   |   |   | X |   |   |   |   |   | X |
---------------------------------------------
- E |   | X |   |   |   | X |   |   |   |   |
---------------------------------------------
- F |   |   |   |   |   |   |   |   |   | X |
---------------------------------------------
- G | X |   |   | X |   | X |   |   |   |   |
---------------------------------------------
- H | X |   |   | X |   |   |   |   | X |   |
---------------------------------------------
- I |   |   |   |   |   |   |   |   |   | X |
---------------------------------------------
- J |   |   | X |   |   |   |   |   |   |   |
---------------------------------------------
     1   2   3   4   5   6   7   8   9   10   
- A | X |   |   |   |   |   | X |   |   |   |
---------------------------------------------
- B |   |   |   |   |   |   |   |   |   |   |
---------------------------------------------
- C |   | X | X |   |   | X |   |   |   |   |
---------------------------------------------
- D |   |   |   |   |   |   |   |   |   |   |
---------------------------------------------
- E |   |   |   | X |   |   |   |   |   |   |
---------------------------------------------
- F |   | X |   |   |   |   |   |   |   |   |
---------------------------------------------
- G |   |   | X |   |   |   |   |   |   |   |
---------------------------------------------
- H |   |   |   |   |   |   | X | X |   |   |
---------------------------------------------
- I | X |   |   |   | X |   |   |   |   |   |
---------------------------------------------
- J |   |   | X |   |   |   |   |   |   |   |
---------------------------------------------
     1   2   3   4   5   6   7   8   9   10   
- A | X |   |   |   |   |   |   |   |   |   |
---------------------------------------------
- B |   |   |   |   |   | X |   |   |   |   |
---------------------------------------------
- C |   |   |   |   | X | X |   |   |   |   |
---------------------------------------------
- D | X |   |   |   |   |   |   |   |   |   |
---------------------------------------------
- E |   |   | X |   |   |   | X | X |   |   |
---------------------------------------------
- F |   |   |   |   |   |   |   |   | X |   |
---------------------------------------------
- G |   |   |   |   |   |   |   |   |   |   |
---------------------------------------------
- H |   |   |   |   | X | X |   |   |   |   |
---------------------------------------------
- I |   |   |   | X | X |   |   |   | X |   |
---------------------------------------------
- J |   |   |   |   |   |   |   |   |   | X |
---------------------------------------------
     1   2   3   4   5   6   7   8   9   10   
- A |   |   |   |   |   |   |   |   |   |   |
---------------------------------------------
- B |   |   |   | X |   |   |   |   |   |   |
---------------------------------------------
- C |   |   |   |   |   |   |   |   |   |   |
---------------------------------------------
- D | X |   |   | X | X |   |   | X |   |   |
---------------------------------------------
- E |   |   |   |   |   |   |   |   |   | X |
---------------------------------------------
- F | X |   | X |   | X |   |   |   |   |   |
---------------------------------------------
- G |   |   |   | X |   | X |   |   |   |   |
---------------------------------------------
- H |   | X |   |   | X |   |   |   |   |   |
---------------------------------------------
- I |   |   | X | X |   |   |   |   |   | X |
---------------------------------------------
- J |   |   |   |   | X |   |   |   |   |   |
---------------------------------------------
     1   2   3   4   5   6   7   8   9   10   
- A |   |   |   |   |   | X | X |   |   | X |
---------------------------------------------
- B |   |   |   |   |   |   |   | X | X |   |
---------------------------------------------
- C |   |   |   |   |   |   |   |   |   |   |
---------------------------------------------
- D |   |   | X |   |   | X | X |   |   |   |
---------------------------------------------
- E |   | X |   | X |   |   |   |   |   |   |
---------------------------------------------
- F |   | X |   |   |   |   |   |   |   |   |
---------------------------------------------
- G |   |   | X |   | X |   |   |   |   |   |
---------------------------------------------
- H |   |   |   |   | X |   |   |   |   |   |
---------------------------------------------
- I | X |   |   |   |   |   |   |   |   |   |
---------------------------------------------
- J |   |   |   |   |   |   |   | X |   |   |
---------------------------------------------
     1   2   3   4   5   6   7   8   9   10   
- A |   | X |   |   |   |   | X |   |   |   |
---------------------------------------------
- B |   |   |   |   | X | X |   |   |   |   |
---------------------------------------------
- C |   |   |   |   |   | X |   |   |   |   |
---------------------------------------------
- D |   |   |   |   |   | X |   |   | X |   |
---------------------------------------------
- E |   |   |   |   |   | X |   |   |   |   |
---------------------------------------------
- F |   |   | X |   |   |   |   |   |   |   |
---------------------------------------------
- G |   |   |   |   |   |   |   |   |   |   |
---------------------------------------------
- H | X |   |   |   |   |   | X |   | X |   |
---------------------------------------------
- I |   |   | X |   | X |   | X |   |   |   |
---------------------------------------------
- J |   |   |   |   |   | X |   |   |   |   |
---------------------------------------------
     1   2   3   4   5   6   7   8   9   10   
- A |   |   |   |   |   |   | X |   |   |   |
---------------------------------------------
- B |   |   |   |   |   |   |   |   |   |   |
---------------------------------------------
- C |   |   |   |   |   |   |   | X |   |   |
---------------------------------------------
- D |   |   |   |   |   |   |   |   |   |   |
---------------------------------------------
- E |   |   |   | X | X |   |   |   |   |   |
---------------------------------------------
- F |   |   |   |   |   |   |   |   |   |   |
---------------------------------------------
- G |   | X |   | X |   |   |   |   |   |   |
---------------------------------------------
- H |   | X |   | X |   | X |   |   |   |   |
---------------------------------------------
- I |   |   |   |   |   |   | X |   |   |   |
---------------------------------------------
- J |   |   |   |   |   |   |   |   |   |   |
---------------------------------------------
     1   2   3   4   5   6   7   8   9   10   
- A |   |   |   |   |   |   |   |   |   | X |
---------------------------------------------
- B | X |   |   |   |   |   |   | X |   | X |
---------------------------------------------
- C |   |   |   | X | X |   |   |   | X |   |
---------------------------------------------
- D |   |   |   |   |   |   |   |   |   |   |
---------------------------------------------
- E |   |   | X |   |   |   |   |   |   |   |
---------------------------------------------
- F |   |   |   |   |   |   |   |   |   | X |
---------------------------------------------
- G |   |   |   |   |   |   |   |   |   |   |
---------------------------------------------
- H |   |   |   |   |   |   |   |   |   |   |
---------------------------------------------
- I |   |   |   |   |   |   |   |   |   | X |
---------------------------------------------
- J |   |   |   |   |   | X |   |   |   |   |
---------------------------------------------
     1   2   3   4   5   6   7   8   9   10   
- A |   | X |   |   |   |   | X |   |   |   |
---------------------------------------------
- B |   | X |   |   |   | X |   |   |   |   |
---------------------------------------------
- C |   |   |   |   |   |   |   |   |   |   |
---------------------------------------------
- D |   |   |   |   |   |   |   |   |   |   |
---------------------------------------------
- E |   |   | X |   |   |   |   |   |   |   |
---------------------------------------------
- F |   |   |   | X | X |   |   |   |   |   |
---------------------------------------------
- G |   | X | X |   | X |   | X |   | X |   |
---------------------------------------------
- H |   |   |   |   |   |   |   |   |   |   |
---------------------------------------------
- I |   |   |   | X |   |   |   |   |   | X |
---------------------------------------------
- J | X |   |   |   | X |   |   |   |   |   |
---------------------------------------------
     1   2   3   4   5   6   7   8   9   10   
- A |   |   |   |   |   |   |   |   |   |   |
---------------------------------------------
- B |   |   | X |   |   |   |   |   |   |   |
---------------------------------------------
- C |   |   |   | X |   |   |   | X |   |   |
---------------------------------------------
- D |   |   |   |   |   |   |   |   |   |   |
---------------------------------------------
- E |   |   |   |   |   |   |   |   |   |   |
---------------------------------------------
- F |   |   |   | X |   |   |   |   |   |   |
---------------------------------------------
- G |   | X |   |   |   |   |   |   |   |   |
---------------------------------------------
- H |   |   | X |   |   |   |   |   |   |   |
---------------------------------------------
- I | X |   |   |   | X |   |   |   | X |   |
---------------------------------------------
- J | X |   |   |   |   | X |   |   |   |   |
---------------------------------------------
     1   2   3   4   5   6   7   8   9   10   
- A |   |   |   |   |   |   |   |   |   |   |
---------------------------------------------
- B | X |   |   |   |   |   |   |   |   |   |
---------------------------------------------
- C |   |   |   |   |   |   | X |   |   |   |
---------------------------------------------
- D | X | X |   |   |   |   | X |   |   |   |
---------------------------------------------
- E |   |   |   |   |   |   |   |   |   |   |
---------------------------------------------
- F |   |   |   | X | X | X |   |   |   |   |
---------------------------------------------
- G |   |   |   |   |   | X |   |   |   | X |
---------------------------------------------
- H |   |   |   |   |   | X | X |   |   |   |
---------------------------------------------
- I |   |   |   |   |   | X |   | X |   |   |
---------------------------------------------
- J |   |   |   |   |   |   |   |   |   |   |
---------------------------------------------
     1   2   3   4   5   6   7   8   9   10   
- A |   |   |   |   |   |   |   |   |   |   |
---------------------------------------------
- B |   |   |   |   | X |   |   |   |   |   |
---------------------------------------------
- C |   | X |   |   |   |   | X |   |   |   |
---------------------------------------------
- D |   |   |   | X |   | X |   |   |   |   |
---------------------------------------------
- E |   |   |   |   |   |   |   |   |   |   |
---------------------------------------------
- F |   |   |   |   |   |   |   |   |   |   |
---------------------------------------------
- G |   |   |   |   |   |   |   |   |   |   |
---------------------------------------------
- H |   |   |   |   |   | X |   |   | X |   |
---------------------------------------------
- I |   |   |   |   |   | X |   |   |   |   |
---------------------------------------------
- J | X |   |   |   |   |   |   |   |   |   |
---------------------------------------------
